13,5,5,5,5,5,5,5,5,3
9,5,5,5,5,5,5,5,5,6
12,5,5,5,5,5,5,5,5,3
9,5,5,5,5,5,5,5,5,6
12,5,5,5,5,5,5,5,5,3
9,5,5,5,5,5,5,5,5,6
12,5,5,5,5,5,5,5,5,3
9,5,5,5,5,5,5,5,5,6
10,9,3,9,3,9,3,9,1,3
12,6,12,6,12,6,12,6,14,14